FCB = "countries/FreeCityOfBerlin.txt"
MLA = "countries/Malaya.txt"
SLV = "countries/Slovenia.txt"
KOS = "countries/Kosovo.txt"
PDG	= "countries/GreeceCommunist.txt"
INO	= "countries/Indonesia.txt"
VIE = "countries/Vietnam.txt"
MYR = "countries/Myanmar.txt"
PAK = "countries/Pakistan.txt"
CPI = "countries/CommunistIndia.txt"
KPA = "countries/NorthKorea.txt"
CEY = "countries/Ceylon.txt"
CCN = "countries/Chechnya.txt"
SAR = "countries/Saarland.txt"
TTP = "countries/TrustTerritoryofthePacificIslands.txt"
AND = "countries/Andorra.txt"
TRI = "countries/Trieste.txt"
LOS = "countries/Laos.txt"
CMB = "countries/Cambodia.txt"
KUR = "countries/Kurdistan.txt"
UAR = "countries/UnitedArabRepublic.txt"
UAS = "countries/UnitedArabStates.txt"
FAR = "countries/FederationofArabRepublics.txt"
ARF = "countries/ArabFederation.txt"
DRY = "countries/PeoplesDemocraticRepublicofYemen.txt"
SUD = "countries/Sudan.txt"
GHA = "countries/Ghana.txt"
MAY = "countries/Mayala.txt"
NIA = "countries/Nigeria.txt"
SOR = "countries/SomaliRepublic.txt"
SDR = "countries/SomaliDemRepublic.txt"
CYP = "countries/Cyprus.txt"
UGA = "countries/Uganda.txt"
JAM = "countries/Jamaica.txt"
TAT = "countries/TrinidadandTobago.txt"
LES = "countries/Lesotho.txt"
SWA = "countries/Swaziland.txt"
ZAM = "countries/Zambia.txt"
KNA = "countries/Kenya.txt"
TAG = "countries/Tanganyika.txt"
TAZ = "countries/Tanzania.txt"
KUW = "countries/Kuwait.txt"
ETR = "countries/EastTurkestanRepublic.txt"
MOR = "countries/Morocco.txt"
TUN = "countries/Tunisia.txt"
ALG = "countries/Algeria.txt"
BRU = "countries/Brunei.txt"
MLI = "countries/Mali.txt"
NIG = "countries/Niger.txt"
BRK = "countries/BurkinaFaso.txt"
GUI = "countries/Guinea.txt"
MAU = "countries/Mauritania.txt"
TOG = "countries/Togo.txt"
BEN = "countries/Benin.txt"
SEN = "countries/Senegal.txt"
CHA = "countries/Chad.txt"
CTD = "countries/CotedIvoire.txt"
NYA = "countries/Malawi.txt"
FBU = "countries/FrancoBritishUnion.txt"
MLD = "countries/Moldavia.txt"
KAZ = "countries/Kazakhstan.txt"
UZB = "countries/Uzbekistan.txt"
TJK = "countries/Tajikistan.txt"
KRG = "countries/Kyrgyzstan.txt"
TRK = "countries/Turkmenistan.txt"
KRL = "countries/Karelia.txt"
MNG = "countries/MongoliaSSR.txt"
MNC = "countries/ManchuSSR.txt"
UYG = "countries/Uyghuria.txt"
BRP = "countries/Baltia.txt"
JMT = "countries/Jamtland.txt"
VGD" = countries/Vastergotland.txt"
ADR = "countries/AustrianDemocraticRepublic.txt"
CSA = "countries/ConfederateStatesofAmerica.txt"
RNA = "countries/NewAfrika.txt"
CSD = "countries/Cascadia.txt"
#Releaseable Countries India Subcontinent
BAL = "countries/Balochistan.txt"
BAN = "countries/Bangladesh.txt"
ASA = "countries/Assam.txt"
KHA = "countries/Khalistan.txt"
KAS = "countries/Kashmir.txt"
CTL = "countries/Catalonia.txt"
MAC = "countries/Macedonia.txt"
SKL = "countries/Skane.txt"

#News Countries ex-colonies France
CAR = "countries/CentralAfrica.txt"
CMR = "countries/Cameroon.txt"
DOC = "countries/DemocraticOfCongo.txt"
GEQ = "countries/GuineaEquatorial.txt"
MAD = "countries/Madagascar.txt"
GAB = "countries/Gabon.txt"
ROC = "countries/RepublicOfCongo.txt"

#Indonesian Indepdence War ie the great clusterfuck of 1949
EIN = "countries/EastIndonesia.txt"
PAS = "countries/Pasundan.txt"
DAR = "countries/DarulIslam.txt"
GDA = "countries/GreatDayak.txt"
PON = "countries/Pontianak.txt"

#More British Countries
BSL = "countries/BritishSomaliland.txt"

#India
MNI = "countries/Manipur.txt"
TRP = "countries/Tripura.txt"
SKK = "countries/Sikkim.txt"

#Tibet
NGO = "countries/Ngolok.txt"

#New Rebellions
CPH = "countries/Hukbalahap.txt"
